┏━━━┳━┓╋┏┳━━┳━━━┳━┓┏━┳━━━┓ ┏━┓┏━┳━━━┳━━━━┳━━━┓
┃┏━━┫┃┗┓┃┣┫┣┫┏━┓┃┃┗┛┃┃┏━┓┃ ┃┃┗┛┃┃┏━┓┣━━┓━┃┏━━┛
┃┗━━┫┏┓┗┛┃┃┃┃┃╋┗┫┏┓┏┓┃┃╋┃┃ ┃┏┓┏┓┃┃╋┃┃╋┏┛┏┫┗━━┓
┃┏━━┫┃┗┓┃┃┃┃┃┃┏━┫┃┃┃┃┃┗━┛┃ ┃┃┃┃┃┃┗━┛┃┏┛┏┛┃┏━━┛
┃┗━━┫┃╋┃┃┣┫┣┫┗┻━┃┃┃┃┃┃┏━┓┃ ┃┃┃┃┃┃┏━┓┣┛━┗━┫┗━━┓
┗━━━┻┛╋┗━┻━━┻━━━┻┛┗┛┗┻┛╋┗┛ ┗┛┗┛┗┻┛╋┗┻━━━━┻━━━┛
